Nicotinate	Nicotinate
NaMN	NAMN
Quinolinate	Quin
L-Tryptophan	Trp
Nicotinamide	NAM
NAD	NAD
NMN	NMN
NADH	NADH
Lysine	Lys
L-Tyrosine	Tyr
Phenylalanine	Phe
Methionine	Met
Homocysteine	Hcy
Cystathionine	Cystathionine
2-Oxobutyric acid	Oxobutyrate
N-Acetylasparagine	N-acetylasparagine
Asparagine	Asn
L-Threonine	Thr
L-Aspartate	Asp
N-acetylaspartate	NAA
Citrulline	Cit
Carbamoyl P	Carbamoyl-P
L-Glutamine	Gln
Putrescine	Put
Spermidine	Spd
Spermine	Spm
Glycine	Gly
L-Serine	Ser
L-Cysteine	Cys
L-Cysteic acid	Cysteate
Argininosuccinic acid	Argininosuccinate
DHAP	DHAP
D-Glucose	Glucose
Glucose 6-phosphate	G6P
6P-Gluconolactone	6Pgluconolactone
Fructose 6-phosphate	F-6P
Fructose 1,6-bisphosphate	F-1,6bP
Glyceraldehyde 3-phosphate	G-3P
1,3BPG	1,3bPG
3PG	3P-G
2PG	2P-G
Phosphoenol pyruvate	PEP
Lactate	Lactate
Pyruvate	Pyruvate
CoA	CoA
Acetyl-CoA	Acetyl-CoA
Citrate	Citrate
Oxaloacetate	OAA
D-Malate	Malate
Fumarate	Fumarate
Arginine	Arg
Urea	Urea
Ornithine	Orn
Guanidinoacetate	Guanidinoacetate
Creatine	Crt
Creatine Phosphate	CrtP
Succinate	Succinate
cis-Aconitic acid	cis-Aconitate
Isocitrate	Isocitrate
alpha-Ketoglutarate	aKG
R 2-HG	2HG
Succinyl-CoA	Succinyl-CoA
Methylmalonyl-CoA	Methylmalonyl-CoA
L-Isoleucine	Ile
L-Leucine	Leu
L-Valine	Val
6-Phospho-D-gluconate	6P-gluconate
Ribulose-5P	Ribulose-5P
Xylulose-5P	Xylulose-5P
D-Ribose 5-phosphate	Ribose-5P
Sedoheptulose-7-phosphate	Sedoheptulose-7P
Erythrose-4P	Erythrose-4P
Fructose 6-phosphate	F-6P
N-Carbamoyl-L-aspartate	Carbamoyl asparate
 L-Dihydroorotate	DHO
Orotic acid	Orotate
PRPP	PRPP
Orotidine-5P	Orotidine-5P
dCTP	dCTP
CTP	CTP
UTP	UTP
dCDP	dCDP
CDP	CDP
UDP	UDP
dUTP	dUTP
dTTP	dTTP
dTDP	dTDP
dUDP	dUDP
dCMP	dCMP
CMP	CMP
UMP	UMP
dUMP	dUMP
dTMP	dTMP
Deoxycytidine	dC
Cytidine	C
Cytosine	Cytosine
Uridine	U
Uracil	Uracil
Deoxyuridine	dU
Thymidine	dT
Thymine	Thymine
dGTP	dGTP
GTP	GTP
cGMP	cGMP
dGDP	dGDP
GDP	GDP
dGMP	dGMP
GMP	GMP
Guanosine	Guanosine
Guanine	Guanine
SAICAR	SAICAR
AICAR	AICAR
IMP	IMP
Inosine	Inosine
XMP	XMP
Xanthosine	Xanthosine
Hypoxanthine	Hypoxanthine
Uric Acid	Urate
Cyclic AMP	cAMP
ATP	ATP
dATP	dATP
ADP	ADP
dADP	dADP
dAMP	dAMP
AMP	AMP
Adenosine	Adenosine
S-Adenosyl-L-homocysteine	SAH
Adenine	Adenine
5-Methylthioadenosine	MTA
L-Alanine	Ala
Pyruvate	Pyr
L-Glutamate	Glu
gamma-Glutamylcysteine	GGC
L-Glutathione reduced	GSH
L-Glutathione oxidized	GSSG
5-oxoproline	5-Oxoproline
Glutamyl P	Glutamyl-P
Glutamate semialdehyde	Glutamate semialdehyde
L-Histidine	His
Pyrroline carboxylate	Pyrroline carboxylate
L-Proline	Pro
cis-4-Hydroxy-D-proline	Hydroxyproline
S-adenosylmethionine	SAM
5-Methyltetrahydrofolate	5-M-THF
Tetrahydrofolate	5-THF
5,10-Methylenetetrahydrofolate	5,10-Methylene-THF
10-Formyltetrahydrofolate	10-F-THF
NADP	NADP
NADPH	NADPH
Taurine	Taurine
Hypotaurine	Hypotaurine
Cysteine sulfinate	CSA
